My Funny Valentine	Saez
Rock'n'Roll Star	Saez
Amandine II	Saez
Soleil 2000	Saez
Hallelujah	Saez
Crépuscule	Saez
Jours Etranges	Saez
J'Veux M'En Aller	Saez
Jeune Et Con	Saez
Sauver Cette Etoile	Saez
L'Heure D'Eté	Grand Corps Malade
A Montréal	Grand Corps Malade
Nos Absents	Grand Corps Malade
Bulletin Météo	Grand Corps Malade
Rachid Taxi	Grand Corps Malade
Jour De Doute	Grand Corps Malade
Un Verbe	Grand Corps Malade
J'Attends	Grand Corps Malade
Tu Es Donc J'Apprends	Charles Aznavour
Roméo Kiffe Juliette	Grand Corps Malade
Education Nationale	Grand Corps Malade
A L'Ecole De La Vie	Grand Corps Malade
Définitivement	Grand Corps Malade
1er Janvier 2010	Grand Corps Malade
Only In Dreams	Weezer
Holiday	Weezer
In The Garage	Weezer
Say It Ain't So	Weezer
Undone -- The Sweater Song	Weezer
Surf Wax America	Weezer
The World Has Turned And Left Me Here	Weezer
Buddy Holly	Weezer
No One Else	Weezer
My Name Is Jonas	Weezer
O Girlfriend	Weezer
Glorious Day	Weezer
Simple Pages	Weezer
Smile	Weezer
Knockdown Dragout	Weezer
Crab	Weezer
Island In The Sun	Weezer
Hash Pipe	Weezer
Photograph	Weezer
Don't Let Go	Weezer
Chanson De Toile	Emilie Simon
Blue Light	Emilie Simon
Flowers	Emilie Simon
Vu D'Ici	Emilie Simon
Graines D'Etoiles	Emilie Simon
Dernier Lit	Emilie Simon
Dernier Lit	Emilie Simon
To The Dancers In The Rain	Emilie Simon
Il Pleut	Emilie Simon
I Wanna Be Your Dog	Emilie Simon
Lise	Emilie Simon
Secret	Emilie Simon
Desert - Version Française	Emilie Simon
Bronte	Gotye
Giving Me A Chance	Gotye
Save Me	Gotye
Don’t Worry, We’ll Be Watching You	Gotye
State Of The Art	Gotye
I Feel Better	Gotye
In Your Light	Gotye
Eyes Wide Open	Gotye
Smoke And Mirrors	Gotye
Somebody That I Used To Know	Gotye
Easy Way Out	Gotye
Making Mirrors	Gotye
So I Need You	3 Doors Down
Smack	3 Doors Down
Down Poison	3 Doors Down
By My Side	3 Doors Down
The Better Life	3 Doors Down
Life Of My Own	3 Doors Down
Not Enough	3 Doors Down
Be Like That	3 Doors Down
Duck And Run	3 Doors Down
Loser	3 Doors Down
Kryptonite	3 Doors Down
Fjögur píanó	Sigur Rós
Valtari	Sigur Rós
Dauðalogn	Sigur Rós
Varðeldur	Sigur Rós
Rembihnútur	Sigur Rós
Varúð	Sigur Rós
Ekki múkk	Sigur Rós
Ég anda	Sigur Rós
Let's Forget All The Things That We Say	Julia Stone
The Shit That They're Feeding You (Bonus Track)	Julia Stone
Take Me Home (Bonus Track)	Julia Stone
Tell Her A Story (Bonus Track)	Julia Stone
The Line That Ties Me	Julia Stone
I Want To Live Here	Julia Stone
By The Horns	Julia Stone
Break Apart	Julia Stone
With The Light	Julia Stone
Justine	Julia Stone
I’m Here, I’m Not Here	Julia Stone
Bloodbuzz Ohio	Julia Stone
Bloodbuzz Ohio	Julia Stone
It's All Okay	Julia Stone
Friday I'm In Love	The Cure
Horse And Cart	Angus & Julia Stone
Another Day	Angus & Julia Stone
Jewels And Gold	Angus & Julia Stone
Soldier	Angus & Julia Stone
Stranger	Angus & Julia Stone
Silver Coin	Angus & Julia Stone
A Book Like This	Angus & Julia Stone
Bella	Angus & Julia Stone
Hollywood	Angus & Julia Stone
Wasted	Angus & Julia Stone
Just a Boy	Angus & Julia Stone
Here We Go Again	Angus & Julia Stone
The Beast	Angus & Julia Stone
Somebody Told Me	The Killers
When You Were Young	The Killers
Human	The Killers
Mr. Brightside	The Killers
Runaways	The Killers
Our Song	The xx
Unfold	The xx
Swept Away	The xx
Tides	The xx
Missing	The xx
Reunion	The xx
Sunset	The xx
Try	The xx
Fiction	The xx
Angels	The xx
Chained	The xx
Someone Like You	Adele
One And Only	Adele
Lovesong	Adele
Take It All	Adele
I'll Be Waiting	Adele
He Won't Go	Adele
Don't You Remember	Adele
Rumour Has It	Adele
Rolling In The Deep	Adele
Good Old Days	P!nk
Run	P!nk
Is This Thing On?	P!nk
My Signature Move	P!nk
The Great Escape	P!nk
Here Comes The Weekend	P!nk
Where Did The Beat Go?	P!nk
Beam Me Up	P!nk
Walk of Shame	P!nk
The Truth About Love	P!nk
How Come You're Not Here	P!nk
Slut Like You	P!nk
Just Give Me a Reason	P!nk
True Love	P!nk
Try	P!nk
Blow Me (One Last Kiss)	P!nk
Are We All We Are	P!nk
People Help The People	Birdy
No Angel	Birdy
Only If For A Night	Florence + The Machine
Turning Tables	Adele
Set Fire To The Rain	Adele
If You Go Away	Emiliana Torrini
Better Days	Ayo
Take My Hand	Dido
My Life	Dido
Isobel	Dido
I'm No Angel	Dido
Slide	Dido
Honestly Ok	Dido
All You Want	Dido
Thank You	Dido
My Lover's Gone	Dido
Don't Think Of Me	Dido
Hunter	Dido
Here with Me	Dido
The Future	Nada Surf
No Snow On the Mountain	Nada Surf
Looking Through	Nada Surf
Let the Fight Do the Fighting	Nada Surf
The Moon Is Calling	Nada Surf
Teenage Dreams	Nada Surf
Jules and Jim	Nada Surf
When I Was Young	Nada Surf
Waiting for Something	Nada Surf
Clear Eye Clouded Mind	Nada Surf
Beloved Freak	Garbage
Man On A Wire	Garbage
Battle In Me	Garbage
Sugar	Garbage
I Hate Love	Garbage
Felt	Garbage
Not Your Kind Of People	Garbage
Control	Garbage
Big Bright World	Garbage
Blood For Poppies	Garbage
Automatic Systematic Habit	Garbage
Sometimes It Snows In April	Prince
Shock To Your System	Tegan And Sara
Now I'm All Messed Up	Tegan And Sara
Love They Say	Tegan And Sara
I Couldn't Be Your Friend	Tegan And Sara
How Come You Don't Want Me	Tegan And Sara
I'm Not Your Hero	Tegan And Sara
Drove Me Wild	Tegan And Sara
Goodbye, Goodbye	Tegan And Sara
I Was A Fool	Tegan And Sara
Closer	Tegan And Sara
Lovers' Revolution	Iron & Wine
Baby Center Stage	Iron & Wine
New Mexico's No Breeze	Iron & Wine
Winter Prayers	Iron & Wine
Singers and the Endless Song	Iron & Wine
Sundown (Back in the Briars)	Iron & Wine
Grass Widows	Iron & Wine
Grace for Saints and Ramblers	Iron & Wine
Low Light Buddy Of Mine	Iron & Wine
Joy	Iron & Wine
The Desert Babbler	Iron & Wine
Caught in the Briars	Iron & Wine
Goodbyes	3 Doors Down
There's A Life	3 Doors Down
One Light	3 Doors Down
Away From The Sun	3 Doors Down
Duck And Run	3 Doors Down
Be Like That	3 Doors Down
Loser	3 Doors Down
Let Me Go	3 Doors Down
It's Not My Time	3 Doors Down
Here Without You	3 Doors Down
When I'm Gone	3 Doors Down
Kryptonite	3 Doors Down
Rafstraumur (Cyril Hahn Remix)	Sigur Rós
Var	Sigur Rós
Bláþráður	Sigur Rós
Rafstraumur	Sigur Rós
Kveikur	Sigur Rós
Stormur	Sigur Rós
Yfirborð	Sigur Rós
Ísjaki	Sigur Rós
Hrafntinna	Sigur Rós
Brennisteinn	Sigur Rós
Something's Wrong	K's Choice
Old Woman	K's Choice
Only Dreaming	K's Choice
My Record Company	K's Choice
Paradise In Me	K's Choice
Wait	K's Choice
To This Day	K's Choice
Iron Flower	K's Choice
Song For Catherine	K's Choice
Mr. Freeze	K's Choice
White Kite Fauna	K's Choice
Not An Addict	K's Choice
A Sound That Only You Can Hear	K's Choice
Sit By Me	SEA + AIR
Wild Flowers	SEA + AIR
Cry Myself to Sleep	SEA + AIR
Let Me Stay	SEA + AIR
Do Animals Cry - Catgone_MouseParty_Remix	SEA + AIR
My Heart`s Sickest Chord	SEA + AIR
1st Life	SEA + AIR
Like a Spy On the Roof	SEA + AIR
Yeah I Know	SEA + AIR
The Heart of the Rainbow	SEA + AIR
Do Animals Cry?	SEA + AIR
You & I	SEA + AIR
Safe from Harm	SEA + AIR
You Don`t Care About Me	SEA + AIR
Dirty Love	SEA + AIR
The Sea After a Storm	SEA + AIR
Mercy Street	SEA + AIR
Take Me for a Ride	SEA + AIR
Dog Days Are Over - MTV Unplugged, 2012	Florence + The Machine
Shake It Out - MTV Unplugged, 2012	Florence + The Machine
Jackson - MTV Unplugged, 2012	Florence + The Machine
What The Water Gave Me - MTV Unplugged, 2012	Florence + The Machine
Try A Little Tenderness - MTV Unplugged, 2012	Florence + The Machine
No Light, No Light - MTV Unplugged, 2012	Florence + The Machine
Never Let Me Go - MTV Unplugged, 2012	Florence + The Machine
Breaking Down - MTV Unplugged, 2012	Florence + The Machine
Cosmic Love - MTV Unplugged, 2012	Florence + The Machine
Drumming Song - MTV Unplugged, 2012	Florence + The Machine
Only If For A Night - MTV Unplugged, 2012	Florence + The Machine
Bosco	Placebo
Begin The End	Placebo
Purify	Placebo
Exit Wounds	Placebo
A Million Little Pieces	Placebo
Rob The Bank	Placebo
Hold On To Me	Placebo
Scene Of The Crime	Placebo
Too Many Friends	Placebo
Loud Like Love	Placebo
St. Augustine	Band of Horses
Monsters	Band of Horses
I Go To The Barn Because I Like The	Band of Horses
Weed Party	Band of Horses
The Great Salt Lake	Band of Horses
Part One	Band of Horses
Our Swords	Band of Horses
The Funeral	Band of Horses
Wicked Gil	Band of Horses
The First Song	Band of Horses
Gold Dust Woman	Fleetwood Mac
Oh Daddy	Fleetwood Mac
I Don't Want To Know	Fleetwood Mac
You Make Loving Fun	Fleetwood Mac
The Chain	Fleetwood Mac
Go Your Own Way	Fleetwood Mac
Songbird	Fleetwood Mac
Never Going Back Again	Fleetwood Mac
Don't Stop	Fleetwood Mac
Dreams	Fleetwood Mac
Second Hand News	Fleetwood Mac
When We Were Young	London Grammar
Maybe	London Grammar
High Life	London Grammar
Help Me Lose My Mind	Disclosure
Darling Are You Gonna Leave Me	London Grammar
Help	London Grammar
If You Wait	London Grammar
Flickers	London Grammar
Interlude - Live	London Grammar
Metal & Dust	London Grammar
Nightcall	London Grammar
Strong	London Grammar
Sights	London Grammar
Wasting My Young Years	London Grammar
Stay Awake	London Grammar
Shyer	London Grammar
Hey Now	London Grammar
Surrender	Bettens
Not an Addict	Sarah Bettens
Follow Me	Sarah Bettens
Daddy's Gun	Sarah Bettens
Scream	Sarah Bettens
I Can't Make You Love Me	Sarah Bettens
Go	Sarah Bettens
Win Me Over	Sarah Bettens
Come Over Here	Sarah Bettens
Cry Me a River	Sarah Bettens
Slow You Down	Sarah Bettens
I Can Do Better Than You	Sarah Bettens
Maneater	Grace Mitchell
#9 Dream	José González
Space Oddity - Mitty Mix	David Bowie
The Wolves & The Ravens	Rogue Valley
Don't You Want Me	Bahamas
Escape (The Pina Colada Song)	Jack Johnson
Lake Michigan	Rogue Wave
Don't Let It Pass	Junip
Stay Alive	José González
Far Away	Junip
Dirty Paws	Of Monsters And Men
Step Out	José González
Chanchullo - Live	Buena Vista Social Club
Silencio - Live	Buena Vista Social Club
Candela - Live	Buena Vista Social Club
El Carretero - Live	Buena Vista Social Club
Mandinga - Live	Buena Vista Social Club
Almendra - Live	Buena Vista Social Club
Siboney - Live	Buena Vista Social Club
¿Y Tú Qué Has Hecho? - Live	Buena Vista Social Club
Orgullecida - Live	Buena Vista Social Club
Veinte Años - Live	Buena Vista Social Club
Quizás, Quizás - Live	Buena Vista Social Club
Dos Gardenias - Live	Buena Vista Social Club
Buena Vista Social Club - Live	Buena Vista Social Club
El Cuarto De Tula - Live	Buena Vista Social Club
La Engañadora - Live	Buena Vista Social Club
De Camino a La Vereda - Live	Buena Vista Social Club
Chan Chan - Live	Buena Vista Social Club
I Don't Fit In	Billie The Vision & The Dancers
Above	Billie The Vision & The Dancers
Leave This City	Billie The Vision & The Dancers
Heimlich's Maneuver	Billie The Vision & The Dancers
She's A Keeper	Billie The Vision & The Dancers
Turn Back Home	Billie The Vision & The Dancers
IRL	Billie The Vision & The Dancers
Keep Smiling At The Kids	Billie The Vision & The Dancers
I Just Wanna Dance The All Night Through	Billie The Vision & The Dancers
Queen Of The Dancefloor	Billie The Vision & The Dancers
When You Say Goodbye	Billie The Vision & The Dancers
Give It Back	Billie The Vision & The Dancers
I Seek A Stronger Word	Billie The Vision & The Dancers
Oh, Mama	Aoife O'Donovan
I'm Alone	Aoife O'Donovan
Glowing Heart	Aoife O'Donovan
Pearls	Aoife O'Donovan
Beekeeper	Aoife O'Donovan
Fire Engine	Aoife O'Donovan
Red & White & Blue & Gold	Aoife O'Donovan
Thursday's Child	Aoife O'Donovan
Lay My Burden Down	Aoife O'Donovan
Briar Rose	Aoife O'Donovan
My Heart	K's Choice
Almost Happy	K's Choice
Not an Addict	K's Choice
Believe	K's Choice
Dad	K's Choice
Not an Addict	K's Choice
Waking Light	Beck
Country Down	Beck
Turn Away	Beck
Blackbird Chain	Beck
Phase	Beck
Don't Let It Go	Beck
Wave	Beck
Unforgiven	Beck
Say Goodbye	Beck
Heart Is A Drum	Beck
Morning	Beck
Cycle	Beck
El viento	Manu Chao
La despedida	Manu Chao
La vie A 2	Manu Chao
Minha galera	Manu Chao
Malegría	Manu Chao
Día luna...Día pena	Manu Chao
Welcome to Tijuana	Manu Chao
Por el suelo	Manu Chao
Luna y sol	Manu Chao
Mama Call	Manu Chao
Lágrimas de oro	Manu Chao
Mentira	Manu Chao
Je ne t'aime plus	Manu Chao
Bongo Bong	Manu Chao
Desaparecido	Manu Chao
Clandestino	Manu Chao
I See Fire	Ed Sheeran
Peace Or Violence - Stromae Edit	Stromae
Up Saw Liz	Stromae
Enfants De L'an 2000	Stromae
Alors On Danse - Radio Edit	Stromae
bâtard	Stromae
Te Quiero	Stromae
formidable	Stromae
ta fête	Stromae
tous les mêmes	Stromae
papaoutai	Stromae
Valtari	Sigur Rós
Fjögur píanó	Sigur Rós
Varúð	Sigur Rós
Varðeldur	Sigur Rós
Ekki múkk	Sigur Rós
Ég anda	Sigur Rós
Dauðalogn	Sigur Rós
Rembihnútur	Sigur Rós
Where I Want to Be (California)	Lilly Wood and The Prick
Le Mas	Lilly Wood and The Prick
Where I Want to Be California (Different Sleep Remix)	Lilly Wood and The Prick
Guys in Bands	Lilly Wood and The Prick
Long Way Back	Lilly Wood and The Prick
Into Trouble	Lilly Wood and The Prick
Song to My Grandma	Lilly Wood and The Prick
Briquet	Lilly Wood and The Prick
Middle of the Night (Ulysses Remix)	Lilly Wood and The Prick
Middle of the Night (Yuksek Remix)	Lilly Wood and The Prick
Joni Mitchell	Lilly Wood and The Prick
Let's Not Pretend	Lilly Wood and The Prick
Middle of the Night (Druzzi Remix)	Lilly Wood and The Prick
Middle of the Night	Lilly Wood and The Prick
No Mark	Lilly Wood and The Prick
Mistakes	Lilly Wood and The Prick
Middle of the Night (Dinovski Remix)	Lilly Wood and The Prick
Another Wave From You	M83
Raconte-Moi Une Histoire	M83
Fountains	M83
Intro	M83
Train To Pluton	M83
Reunion	M83
New Map	M83
Midnight City	M83
Where The Boats Go	M83
Steve McQueen	M83
Echoes Of Mine	M83
This Bright Flash	M83
Soon, My Friend	M83
Outro	M83
My Tears Are Becoming A Sea	M83
OK Pal	M83
Wait	M83
Year One, One UFO	M83
Klaus I Love You	M83
Claudia Lewis	M83
Splendor	M83
When Will You Come Home?	M83
Blown Away	Carrie Underwood
Leave Me Alone (I'm Lonely)	P!nk
Conversations With My 13 Year Old Self	P!nk
Long Way To Happy	P!nk
Fingers	P!nk
The One That Got Away	P!nk
Nobody Knows	P!nk
Centerfold	P!nk
'Cuz I Can	P!nk
Dear Mr. President	P!nk
Stupid Girls	P!nk
Runaway	P!nk
I Got Money Now	P!nk
U + Ur Hand	P!nk
I'm Not Dead	P!nk
Who Knew	P!nk
Andvari	Sigur Rós
Glósóli	Sigur Rós
Gong	Sigur Rós
Sæglópur	Sigur Rós
Með Blóðnasir	Sigur Rós
Takk...	Sigur Rós
Sé Lest	Sigur Rós
Hoppípolla	Sigur Rós
Mílanó	Sigur Rós
Heysátan	Sigur Rós
Svo Hljótt	Sigur Rós
Pearl Lakes	U137
Dreamer on the Run	U137
Anemone	U137
The Nostalgic Tune	U137
Midsummer Field	U137
Sliding Doors	U137
Varberg	U137
Watching the Storm	U137
Let Me Keep This Memory	U137
The Poet	U137
Flowers	Emilie Simon
Fleur De Saison	Emilie Simon
I Wanna Be Your Dog	Emilie Simon
In The Lake	Emilie Simon
Dame De Lotus	Emilie Simon
Come As You Are	Emilie Simon
Sweet Blossom	Emilie Simon
My Old Friend	Emilie Simon
Alicia	Emilie Simon
Ice Girl	Emilie Simon
Graines D'Etoiles	Emilie Simon
Song Of The Storm	Emilie Simon
Le Vieil Amant	Emilie Simon
Désert	Emilie Simon
Never Fall In Love	Emilie Simon
Rose Hybride De Thé	Emilie Simon
Opium	Emilie Simon
Swimming	Emilie Simon
En Cendres	Emilie Simon
The Line That Ties Me	Julia Stone
Let's Forget All The Things That We Say	Julia Stone
The River - Bonus Track	Julia Stone
Justine	Julia Stone
By the Horns	Julia Stone
I Want to Live Here	Julia Stone
Break Apart	Julia Stone
With the Light	Julia Stone
I'm Here, I'm Not Here	Julia Stone
Bloodbuzz Ohio	Julia Stone
It's All Okay	Julia Stone
Firework	Katy Perry
Sadness Is A Blessing	Lykke Li
I Follow Rivers - Tyler, the Creator Remix	Lykke Li
Jerome	Lykke Li
Unrequited Love	Lykke Li
Love Out Of Lust	Lykke Li
I Follow Rivers - The Magician Remix	Lykke Li
I Know Places	Lykke Li
Youth Knows No Pain	Lykke Li
Get Some	Lykke Li
Silent My Song	Lykke Li
Rich Kids Blues	Lykke Li
I Follow Rivers	Lykke Li
Get Some - Remix by Beck	Lykke Li
Get Some - Mike D Remix - Another Latch Bros. Production	Lykke Li
I Never Learn	Lykke Li
Never Gonna Love Again	Lykke Li
No Rest For The Wicked	Lykke Li
Love Me Like I'm Not Made Of Stone	Lykke Li
Silver Line	Lykke Li
Sleeping Alone	Lykke Li
Gunshot	Lykke Li
Heart Of Steel	Lykke Li
Just Like A Dream	Lykke Li
Feel The Love - feat. John Newman	Rudimental
Spoons - feat. MNEK & Syron	Rudimental
Free (feat. Emeli Sandé)	Rudimental
Baby - feat. MNEK & Sinead Harnett	Rudimental
Hide - feat. Sinead Harnett	Rudimental
Right Here - feat. Foxes	Rudimental
Waiting All Night (feat. Ella Eyre)	Rudimental
Not Giving In - feat. John Newman & Alex Clare	Rudimental
More Than Anything - feat. Emeli Sandé	Rudimental
Hell Could Freeze - feat. Angel Haze	Rudimental
Home	Rudimental
Powerless - feat. Becky Hill	Rudimental
Under The Earth	Yeah Yeah Yeahs
Subway - NOLA Demo	Yeah Yeah Yeahs
These Paths	Yeah Yeah Yeahs
Wedding Song - Acoustic	Yeah Yeah Yeahs
Sacrilege	Yeah Yeah Yeahs
Despair	Yeah Yeah Yeahs
Mosquito - Live From Area 52 / 2012	Yeah Yeah Yeahs
Area 52	Yeah Yeah Yeahs
Wedding Song	Yeah Yeah Yeahs
Buried Alive	Yeah Yeah Yeahs
Slave	Yeah Yeah Yeahs
Subway	Yeah Yeah Yeahs
Mosquito	Yeah Yeah Yeahs
Always	Yeah Yeah Yeahs
Despair - Acoustic	Yeah Yeah Yeahs
Blue Moon	Beck
citizen of the planet - live in berlin	Alanis Morissette
magical child	Alanis Morissette
celebrity	Alanis Morissette
versions of violence - live in berlin	Alanis Morissette
spiral	Alanis Morissette
Hand in My Pocket - Live in Berlin	Alanis Morissette
win and win	Alanis Morissette
i remain (segue 1) - live in berlin	Alanis Morissette
woman down	Alanis Morissette
will you be my girlfriend?	Alanis Morissette
woman down - live in berlin	Alanis Morissette
empathy	Alanis Morissette
guardian - live in berlin	Alanis Morissette
guardian	Alanis Morissette
you learn - live in berlin	Alanis Morissette
You Oughta Know - Live In Berlin	Alanis Morissette
head over feet - live in berlin	Alanis Morissette
'til you	Alanis Morissette
numb - live in berlin	Alanis Morissette
edge of evolution	Alanis Morissette
uninvited - live in berlin	Alanis Morissette
ironic - live in berlin	Alanis Morissette
lens	Alanis Morissette
receive	Alanis Morissette
hands clean - live in berlin	Alanis Morissette
havoc	Alanis Morissette
numb	Alanis Morissette
Footballer's Wife	Amy Macdonald
Run	Amy Macdonald
Rock Bottom	Amy Macdonald
Fairy Tale Of New York - Live From Glasgow Barrowlands	Amy Macdonald
A Wish For Something More	Amy Macdonald
This Is The Life - Acoustic Version	Amy Macdonald
This Much Is True	Amy Macdonald
The Road To Home	Amy Macdonald
L.A.	Amy Macdonald
Let's Start A Band	Amy Macdonald
Mr Rock & Roll - Live From Glasgow Barrowlands	Amy Macdonald
Poison Prince	Amy Macdonald
Footballer's Wife - Live From Glasgow Barrowlands	Amy Macdonald
This Is The Life	Amy Macdonald
Mr Rock & Roll	Amy Macdonald
Barrowland Ballroom	Amy Macdonald
Mr. Brightside - Live From Glasgow Barrowlands	Amy Macdonald
Youth Of Today	Amy Macdonald
Don't Swallow the Cap	The National
Hard To Find	The National
Pink Rabbits	The National
Heavenfaced	The National
Graceless	The National
Slipped	The National
Fireproof	The National
I Should Live in Salt	The National
Humiliation	The National
Demons	The National
This Is The Last Time	The National
Sea of Love	The National
I Need My Girl	The National
Somebody New	Amy Macdonald
Perdue Dans Tes Bras	Emilie Simon
Les Etoiles De Paris	Emilie Simon
Le Diamant	Emilie Simon
Des Larmes	Emilie Simon
Quand Vient Le Jour	Emilie Simon
Encre	Emilie Simon
Les Amoureux De Minuit	Emilie Simon
Menteur	Emilie Simon
Wicked Games - Bonus	Emilie Simon
The Eye Of The Moon	Emilie Simon
Paris j'ai pris perpète	Emilie Simon
Square 1	Paul Kalkbrenner
Bengang	Paul Kalkbrenner
Azure	Paul Kalkbrenner
QSA	Paul Kalkbrenner
Aaron	Paul Kalkbrenner
Moob	Paul Kalkbrenner
Train	Paul Kalkbrenner
Torted	Paul Kalkbrenner
Sky and Sand	Paul Kalkbrenner
Absynthe	Paul Kalkbrenner
Peet	Paul Kalkbrenner
Revolte	Paul Kalkbrenner
Variations on a Theme by Mozart, Op.9	Pepe Romero
Las dos hermanitas	Pepe Romero
Romance de los pinos	Pepe Romero
Suite española, Op.47: Asturias (Leyenda)	Pepe Romero
Tango Maria	Pepe Romero
Rosita	Pepe Romero
Jeux interdits (Romance)	Pepe Romero
Fantasia	Pepe Romero
Recuerdos de la Alhambra	Pepe Romero
Capricho árabe	Pepe Romero
Marieta	Pepe Romero
Malagueña	Pepe Romero
Serenata españole	Pepe Romero
Fantasìa XVI	Luis de Milán
El Testament d' Amelia - Rev. Celedonio Romero	Miguel Llobet
Estudio XIX	Fernando Sor
Waltz, Op.39, No.15	Johannes Brahms
Fandanguillo	Joaquin Turina
Prelude in C minor	Johann Sebastian Bach
Guasa (Danza)	Celedonio Romero
Drei Deutsche Tänze - Transcr. Celedonio Romero	Franz Schubert
Album für die Jugend, Op.68 - Transcr. Celedonio Romero: Soldatenmarsch	Robert Schumann
Estudio. La Mariposa	Celedonio Romero
Guajiras. Cuban Fantasy	Celedonio Romero
Danza Andaluza No.1	Celedonio Romero
Gavotte from Suite in E for Lute, BWV 1006a	Johann Sebastian Bach
Madroños	Federico Moreno Torroba
Minuet No.6	Fernando Sor
Minuet No.5	Fernando Sor
Gavotta I & II from Suite for Cello Solo No.6 in D, BWV 1012	Johann Sebastian Bach
Album für die Jugend, Op.68 - Transcr. Celedonio Romero: Melodie	Robert Schumann
Minuet No.7	Fernando Sor
El Noi de la Mare - Rev. Celedonio Romero	Miguel Llobet
Mazurka No.22 in G sharp minor, Op.33 No.1	Frédéric Chopin
Suite for Cello Solo No.3 in C, BWV 1009: 3. Courante	Johann Sebastian Bach
Album für die Jugend, Op.68 - Transcr. Celedonio Romero: Fröhlicher Landmann	Robert Schumann
Romanza	Emilio Pujol Villarrubí
Fandangos Por Verdiales	Pepe Romero
Carabana Gitana	Pepe Romero
Tanguillos	Pepe Romero
Zorongo	Pepe Romero
Farruca Y Rumba	Pepe Romero
Peteneras	Pepe Romero
Fiesta En Jerez	Pepe Romero
Jota	Pepe Romero
Lamento Andaluz	Pepe Romero
Garrotin	Pepe Romero